10 10
_ _______
| |_____|
|______ |
|_____| |
|_ _____|
|| || | |
|| || |_|
|| ____ |
|| |  | |
||_|__| |