12 15
_ _________
| |__| |__|
|         |
|__  |__| |
| |  |__| |
| |     | |
|     |   |
|__ __|__ |
| | |   | |
| |_|   | |
| | |___| |
| | |     |
|_______| |
|         |
___ ____|_|